X X X X X X X X X X X X X X X X X X X X X X X X X X X X X X X X X X X X X
X P O O O O X O O O O O O O O C O O O O O O O O X O O O O O O O O O O O X
X O O O O O X O O O O O O O O O O O O O O O O O X O O O O O O O O O O O X
X O O O O O X O O X X X X O O X O O O O O O O O X O O X X X X O O X O O X
X O O O O O X O O X O O X O O X X X O O O O O O X O O X O O X O O X O O X
X O O O O O X O O X O O X O O O O X O O O O O O X O O X O O X O O X X X X
X O O X X X X O O X O O X O O O O X O O O X X X X O O X O O X O O O O O X
X O O X O O O O O X O O X O O O O X O O O O O O O O O O O O X O O O O O X
X O O X O O O X X X O O X O O X X X O X X X O O O O O O O O X X X X X X X
X O O O O O O O O O O O X O O X O O O X O O O O O O O O O O O O O O O O X
X O O O O O O O O O O O X O O X O O O X O O O O O O O O O O O O O O O O X
X O O O O O X O O O O O O O O X O O O X O O O O O O O O O O O O O O O O X
X O O O O O X O O O O O O O O X O O O X O O O O O O O O O O O O O X O O X
X O O O O O X O O X X X X O O X O O O X O O O O O O O O O O O O O X O O X
X O O O O O X O O X O O X O O X X X O X O O O X X X X O O O O O X X O O X
X O O O O O X O O X O O X O O O O X O X O O O X O O O O O O O O X O O O X
X O O X X X X O O X O O X O O O O X O X O O O X O O O O O X O O X O O O X
X O O X O O O O O O O O O O O O O O O O O O O X O O O O O X O O X O O O X
X O O X O O O C O O O O O O O O O K O O O O O X O O O X X X O O X O O O X
X O O O O O O O O O O O O O X X X X X X X X X X O O O O O O O O X X X X X
X O O O O O O O O O O O O O O O O O O O O O O O O O O O O O O O O O O O X
X X X X X X X X X X X X X X X X X X X X X X X X X X X X X X X X X X X X X